#
XXXXXXXXXXXXXXXX
X++++++++++++++X
X++++++++++++++X
X++++++++++++++X
X++++++++++++++X
X++++++++++++++X
X++++++++++++++X
X++++++++++++++X
X++++++++++++++X
X++++++++++++++X
X++++++++++++++X
X+++e+++e+++e++X
X++++++++++++++X
X++++++++++++++X
X++++++++++++++X
X+++H++++++H+++X
X[[[[[[[[[[[[[[X
X[[[[[[[[[[[[[[X
X++++++++++++++X
XXX++++++++++XXX
X+++++++++++++X
X+++++++++++++X
X+++++++++++++X
X+++++XXX+++++X
X+++++++++++++X
X++L+++S++++L++X
XXXXXXXXXXXXXXXX