MMM
#
1;_
#
XXXXXXXXXXXXXXXXXXXXXXXX
X......................X
X......................X
X......................X
X......................X
X......................X
X..........X...........X
XL...S.....X..H..M.....X
X..........X...........X
X......................X
X......................X
X......................X
X......................X
X......................X
X......................X
X......................X
X......................X
X......................X
XXXXXXXXXXXXXXXXXXXXXXX