G
#
#
XXXXXXXXXXXXX
X..L.....L..X
X.....e.....X
XL.........LX
X....z......X
X..z....z...X
XL....S....LX
X..z...z....X
X..L.z...L..X
XXXXXXXXXXXXX