XXXXXXXXXXX
X....L....XXXXXXXXX
X.................X
X.........XXXXX...X
X.........X   X...X
XXXXX...XXX   X...XXXXXXXXXXXXXXXXXX
    X...X     X..........B.........X
    X...X     X.......E......E.....X
    X...X     X..........E.........X
    X...X     X...X................X
XXXXX...XXXXXXX...X................X
X.................XXXXXXXXXXXX.....X
X..........E.................X.....X
XL....X............................X
X...................XXXXX..........X
X...................X   X....XXXXXXX
X........XXXXXXXX..XX   X....X
XX........X........X   XXXXXX
 X........X.......LX
 X........X........X
 X........L........X
 X...B.............X
 XXXXXX...S...XXXXXXX
      X.......X
      XXXXXXXXX