#
XXXXXXXXXXX
X++++L++++X
X+++++++++X
XL+++S+++LX
X+++++++++X
X++++L++++X
XXXXXXXXXXX