#
#
      XXXXXXXXXXXXXXXXXXX
XXXXXXX.................X
X+S+++X.................X
XB++++|..XX..XXX...XXX..X
X+++++X..L....B.....L...X
X[[[++X..p......P......pXXXXXX
  XXXXX.................|++++X
  X+++XXXXXXXXXXXXXX....XXXX+X
  X+a+++++++e++++++X....XXXX_XXXXXXXX
  X+++++X+++++X++e+X....X.pL..X-E-e-X
  X[[+++X+++++X++++XB...X.....X--;;;X
  X[[+++++;;;;;;a++X...pX..D...--;[;X
  X+++e+++;;;;;;+++X....X......--;[cX
  X+++L+++++L++++++X....X......X-;[;X
  XXXXXXX_XXXXXXXXXX...pX......X-;;;X
  X.........X---L-cX....X..XXXXX-e-LX
  X.........X-E[[--X....X...X.......X
  X..X....e.X--[[--X..P.Xp..X.e.....X
  X..XL.....X------XXX.pX.........A.X
  X..X...XXXXXX_XXXX....X..L..e...L.X
  XXXX..P....l.........pXX_XXXXXXXXXX
     X...................X.X
     X.[[......[[..XXXXXXX.X
     X...e.....[[........X.X
     X.........[[........X.X
     X....[[........[[[..X.X
     XL...[[........[[[.LX.X
     X....[[........[[[..X.X
     XXX..[[..[[[...[[[..X.X
     X....[[..........e..X.X
     X......E............X.X
     X.................XXX.X
     X........X..[[[[....X.X
     X........X..[[[[...lX.X
     X.....l..X....l.....|.X
     XXXXXXXXXXXXXXXXXXXXXXX












